End1|2|E|L|-
End2|2|E|L|-
End3|2|E|R|-
End4|1|E|R|-
End5|1|E|L|-
End6|2|E|R|-
End7|1|E|R|-
End8|2|E|L|-
End9|1|E|L|-
End10|2|E|R|-
End11|1|E|R|-
End11|1|E|R|-
End12|2|E|R|-
End13|1|E|R|-
End14|2|E|L|-
End15|1|E|L|-
End16|2|E|L|-
End17|1|E|L|-
End18|2|E|R|-
End19|1|E|R|-
End20|2|E|L|-
End21|1|E|L|-
End22|2|E|R|-
End23|1|E|R|-
End24|2|E|L|-
End25|1|E|L|-
End25|1|E|L|-
End26|2|E|R|-
End26|1|E|R|-
Mid1|2|M|L|R
Mid2|2|M|R|L
Mid3|2|M|L|L
Mid4|2|M|R|R
Mid5|2|M|R|R
Mid6|2|M|R|L
Mid7|2|M|R|L
Mid8|2|M|L|L
Mid9|2|M|R|L
Mid10|2|M|L|R
Mid11|2|M|L|L
Mid12|2|M|L|R
Mid13|2|M|R|R
Mid14|2|M|L|L
Mid15|2|M|R|R
Mid16|2|M|R|R
Mid17|2|M|R|R
Mid18|2|M|L|L
Mid19|2|M|L|L
Mid20|2|M|R|L
Mid21|2|M|R|R
Mid22|2|M|R|R
Mid23|2|M|L|R
Mid24|2|M|L|R
Mid25|2|M|L|R
Mid26|2|M|R|L
Mid27|2|M|R|L
Mid28|2|M|L|L
Mid29|2|M|L|L
Mid30|2|M|L|L
Mid31|2|M|L|L
Mid32|2|M|L|L
Mid33|2|M|L|L
Mid34|2|M|L|L
Mid35|2|M|L|R
Mid36|2|M|R|R
Mid37|2|M|R|R
Mid38|2|M|R|R
Mid39|2|M|L|R
Mid40|2|M|L|R
Mid41|2|M|R|L
Mid42|2|M|L|L
Mid43|2|M|L|L
Mid44|2|M|L|L
Mid45|2|M|L|R
Mid46|2|M|L|R
Mid47|2|M|R|L
Mid48|2|M|R|L
Mid49|2|M|R|R
Mid50|2|M|R|R
Mid51|2|M|L|L
Mid52|2|M|L|L
Mid53|2|M|L|R
Mid54|2|M|L|R
Mid55|2|M|R|R
Mid56|2|M|R|R
Mid57|2|M|R|L
Mid58|2|M|R|L
Start1|2|S|-|L
Start2|2|S|-|L
Start3|2|S|-|R
Start4|2|S|-|R
Start5|2|S|-|R
Start6|2|S|-|R
Start7|2|S|-|L
Start8|2|S|-|L
Start9|2|S|-|L
Start10|2|S|-|R
Start11|2|S|-|L
Start12|2|S|-|R
Start13|2|S|-|L
Start14|2|S|-|L
Start15|2|S|-|L
